[
    ["w","w","w","w","w","w","w","w","w","w","w","w","w","w","w","w","w","w","w","w","w","w","w","w","w","w","w","w","w","w","w"],
    ["w","k"," "," "," "," "," "," "," "," "," "," "," "," "," "," "," "," "," "," "," "," "," "," "," "," "," "," "," "," ","w"],
    ["w"," "," "," "," "," "," "," "," "," "," "," "," "," "," "," "," ","k"," "," "," "," "," "," "," "," "," "," "," "," ","w"],
    ["w","w","w","w","w","w","w","w","w"," "," "," "," "," "," "," "," "," "," "," "," "," "," "," "," "," "," "," "," "," ","w"],
    ["w"," "," "," "," "," "," "," "," ","k","w"," "," "," "," "," "," "," "," "," "," "," "," "," "," "," "," "," ","w"," ","w"],
    ["w"," ","w","w","w","w","w","w","w","w","w","w","w","w","w","w","w","w","w","w","w","w","w","w","w","w","w","w","w"," ","w"],
    ["w"," "," "," "," "," "," "," "," "," "," "," "," "," "," "," ","w"," "," "," "," "," "," "," "," "," "," "," "," "," ","w"],
    ["w","w","w","w","w","w","w","w","w","w","w","w","w"," "," "," ","w"," "," "," "," "," "," "," "," "," "," "," "," "," ","w"],
    ["w"," "," "," "," "," "," "," ","w","w","w","w"," "," "," "," ","w"," "," "," "," "," "," "," "," "," "," "," "," "," ","w"],
    ["w"," ","w","w","w","w","w"," "," ","w","w","w"," ","w","w","w","w"," "," "," "," "," "," "," "," "," "," "," "," "," ","w"],
    ["w"," "," "," "," "," "," ","w"," "," ","w"," "," "," "," "," ","w"," "," "," "," "," "," "," "," "," "," "," "," "," ","w"],
    ["w"," "," "," "," "," "," "," ","w"," "," ","w","w","w","w"," ","w"," "," "," "," "," "," "," "," "," "," "," "," "," ","w"],
    ["w","w"," "," "," "," "," "," "," ","w"," "," "," "," "," "," ","w"," "," "," "," "," "," "," "," "," "," "," "," "," ","w"],
    ["w"," "," "," "," "," "," "," "," ","w"," "," "," "," "," "," ","w","p"," "," "," "," "," "," "," "," "," "," "," "," ","w"],
    ["w"," "," "," "," "," "," "," "," ","w","w","w","w","w","w","w","w","w"," "," "," "," "," "," "," "," "," "," "," "," ","w"],
    ["w"," ","w","w","w"," "," "," "," "," "," "," "," "," "," "," "," ","w"," "," "," "," "," "," "," "," "," "," "," "," ","w"],
    ["w"," ","w","w","w","w"," "," "," "," "," "," "," "," "," "," "," ","w"," "," "," "," "," "," "," "," "," "," "," "," ","w"],
    ["w"," ","w","w","w","w","w"," "," "," "," "," "," "," "," "," ","m","w","k"," ","k"," ","k"," ","k"," ","k"," ","k"," ","w"],
    ["w","w","w","w","w","w","w","w","w","w","w","w","w","w","w","w","w","w","w","w","w","w","w","w","w","w","w","w","w","w","w"]
]